Hi	hola
woman	mujer
father	padre
he	 él
the	 el
mother	madre
cat	gato
dog	perro
House	casa
home	 hogar
truck	camión
need	 necesita
do	 hacer
his	 su
song	 cancion
brother	 hermano
sister	hermana
one	uno
and	 y
enjoying	 disfrutando
nature	 naturaleza
two	dos
homework	tarea 
monkey	mono
virus	virus
eat	comer
because	 porque
chicken	pollo
sauce	salsa
lenses	lentes
physical	física
programming	programacion
tree	árbol
forest	bosque
wood	madera
I	 yo
boy	 chico
finished	 terminó